2
9 8
. . # # # # # .
# # # - - - # .
# - o b - - # .
# # # - b - # .
# - # # b - # .
# - # - - - # #
# b - b b b - #
# - - - - - - #
# # # # # # # #

. . . . . . . .
. . . . . . . .
. * . . . . . .
. . . . . * . .
. * . . . . . .
. . . . * . . .
. . . * . . * .
. . . . * . . .
. . . . . . . .